111111111111111111111111111111111
1E000000000000C0000C000000000000C1
1010010100100000101001000000010001
1010010100100C00101001000C00010101
1P000000000000000000000000000000001
1111111111111111111111111111111111