1111111111
1C0C0C0C01
1010101011
1C0C0C0C01
1010101011
1C0C0C0CE1
1010101011
1C0C0C0C01
1000P00001
1111111111