1111111111111111111111111
1E0000000000C00000000000C1
1010010100100000101001000001
101001010010C0C0101001000001
1P0000000C00C0000000000000001
1111111111111111111111111