0111111110
1000000001
1P0C0E0001
1000000001
0111111110