111111111
100000001
1P0C0E0
100000001
111111111